cmucl-announce	toy.raymond@gmail.com
cmucl-cvs	toy.raymond@gmail.com
cmucl-imp	toy.raymond@gmail.com
able-cvs	dherring@common-lisp.net
able-devel	dherring@common-lisp.net
alexandria-cvs	nikodemus@random-state.net
alexandria-devel	nikodemus@random-state.net
anaphora-cvs	nikodemus@random-state.net
anaphora-devel	nikodemus@random-state.net
announcements	postmaster
ansi-test-cvs	ehuelsmann@common-lisp.net
ansi-test-devel	ehuelsmann@common-lisp.net
antik-devel	lhealy@common-lisp.net
armedbear-announce	ehuelsmann@common-lisp.net
armedbear-cvs	ehuelsmann@common-lisp.net
armedbear-devel	ehuelsmann@common-lisp.net
armedbear-ticket	ehuelsmann@common-lisp.net
asdf-install-devel	gking@common-lisp.net
asdf-packaging-announce	pscott@common-lisp.net
aspiwork-pdm-cvs	alokhande@common-lisp.net
aspiwork-pdm-devel	alokhande@common-lisp.net
babel-devel	loliveira@common-lisp.net
bese-devel	mb@bese.it
bordeaux-threads-announce	sionescu@cddr.org
bordeaux-threads-ticket	gpfeil@common-lisp.net
boston-lisp	dan.stanger@ieee.org
boston-lisp-organizers	dlowe@common-lisp.net
cdr-announce	pc@p-cos.net
cdr-devel	pc@p-cos.net
cello-devel	ktilton@common-lisp.net
cells-gtk-devel	peter.denno@nist.gov
cffi-devel	loliveira@common-lisp.net
cl-applescript-devel	danieldickison@gmail.com
clbuild-devel	lgorrie@common-lisp.net
cl-bzip2-devel	mail@chaitanyagupta.com
cl-dbf-cvs	rklochkov@common-lisp.net
cl-dwim-devel	alendvai@common-lisp.net
cl-ec2-devel	dyoung@common-lisp.net
cleric-announce	mflambard@common-lisp.net
cl-facebook-devel	rdaly@common-lisp.net
clfswm-cvs	pbrochard@common-lisp.net
clfswm-devel	pbrochard@common-lisp.net
cl-gd-announce	edi@agharta.de
cl-gd-devel	edi@agharta.de
cl-graph-devel	gwking@metabang.com
cl-gtk2-devel	kdmitry@common-lisp.net
climacs-devel	rstrandh@common-lisp.net
climplayer-devel	tompa.persson@gmail.com
cl-irc-cvs	ehuelsmann@common-lisp.net
cl-irc-devel	bmastenbrook@common-lisp.net
cl-json-announce	hhjelte@common-lisp.net
cl-kanren-trs-cvs	mswank@common-lisp.net
cl-l10n-devel	sross@common-lisp.net
cl-monad-macros-cvs	dsorokin@common-lisp.net
cl-muproc-devel	klaus@harbo.net
cl-ncurses-devel	jgabrielson@common-lisp.net
cl-neo4j-devel	kraison@common-lisp.net
clo-cvs	drewc@drewc.org
clonsigna-announce	achiumenti@common-lisp.net
cl-opengl-devel	loliveira@common-lisp.net
cl-openid-ticket	mpasternacki@common-lisp.net
closer-announce	pc@p-cos.net
closer-devel	pc@p-cos.net
closure-devel	gbaumann@common-lisp.net
clouchdb-devel	peddy@common-lisp.net
cl-pdf-devel	mbattyani@common-lisp.net
cl-plus-j-announce	jean.claude.beaudoin@gmail.com
cl-plus-j-devel	jean.claude.beaudoin@gmail.com
cl-plus-ssl-devel	dlichteblau@common-lisp.net
cl-ppcre-announce	edi@agharta.de
cl-ppcre-devel	edi@agharta.de
cl-proc-devel	rstevens@common-lisp.net
cl-rdbms-devel	alendvai@common-lisp.net
cl-sbml-cvs	mantoniotti@common-lisp.net
cl-serializer-devel	alendvai@common-lisp.net
cl-soap-devel	wbendick@common-lisp.net
clsql-fluid-devel	scompall@common-lisp.net
cl-sqlite-devel	dkalyanov@common-lisp.net
cl-table-cvs	rklochkov@common-lisp.net
cl-typesetting-announce	mbattyani@common-lisp.net
cl-typesetting-devel	marc.battyani@fractalconcept.com
cl-utilities-devel	pscott@common-lisp.net
cl-who-announce	edi@agharta.de
cl-who-devel	edi@agharta.de
clx-devel	abridgewater@common-lisp.net
cl-xmpp-devel	eenge@common-lisp.net
common-lisp-beginner-cvs	ffilozov@common-lisp.net
cxml-devel	dlichteblau@common-lisp.net
de-setf-amqp-cvs	janderson@common-lisp.net
docudown-devel	gwking@metabang.com
drakma-announce	edi@agharta.de
eager-future-devel	vsedach@gmail.com
eclm	edi@agharta.de
ecl-readline-devel	jaquilina@common-lisp.net
elephant-devel	lpolzer@common-lisp.net
elephant-ticket	lpolzer@common-lisp.net
f2cl-ticket	toy.raymond@gmail.com
fiveam-announce	sionescu@cddr.org
fiveam-devel	sionescu@cddr.org
flexi-streams-announce	edi@agharta.de
bknr-devel	hhubner@common-lisp.net
asdf-devel	rpgoldman@sift.net
cffi-objects-cvs	rklochkov@common-lisp.net
beirc-devel	dmurray@common-lisp.net
bordeaux-threads-devel	sionescu@cddr.org
boston-lisp-announce	dan.stanger@ieee.org
cdr-discuss	alemmens@xs4all.nl
cells-devel	kentilton@gmail.com
cl-berkeley-db-devel	asmyles@common-lisp.net
cl-containers-devel	gwking@metabang.com
cldoc-devel	ihatchondo@common-lisp.net
cl-emb-devel	sscholl@common-lisp.net
cleric-devel	mflambard@common-lisp.net
clfswm-announce	pbrochard@common-lisp.net
cl-fuse-devel	lbrinkhoff@common-lisp.net
cl-glpk-devel	kkaminski@common-lisp.net
cl-gsl-devel	edenny@common-lisp.net
cl-heap-announce	rneeser@common-lisp.net
cl-interpol-devel	edi@agharta.de
cl-jpeg-devel	ezaikonnikov@common-lisp.net
cl-json-devel	hhjelte@common-lisp.net
cl-kanren-trs-devel	mswank@common-lisp.net
cl-mpi-devel	afukunaga@common-lisp.net
cl-neo4j-cvs	kraison@common-lisp.net
clo-devel	drewc@drewc.org
clonsigna-devel	achiumenti@common-lisp.net
cl-openid-devel	mpasternacki@common-lisp.net
cl-org-mode-devel	dcrampsie@common-lisp.net
clouchdb-cvs	peddy@common-lisp.net
cl-pdf-announce	mbattyani@common-lisp.net
cl-perec-devel	levente.meszaros@gmail.com
cl-plus-ssl-cvs	dlichteblau@common-lisp.net
cl-pop-devel	brian.sorg@liberatinginsight.com
clpython-devel	wbroekema@common-lisp.net
cl-selenium-devel	mkennedy@common-lisp.net
cl-smtp-devel	jidzikowski@common-lisp.net
cl-sqlite-announce	dkalyanov@common-lisp.net
cl-store-devel	sross@common-lisp.net
fm-lisp	edi@agharta.de
fset-devel	sburson@common-lisp.net
ginseng-cvs	wchunye@common-lisp.net
gsharp-devel	rstrandh@common-lisp.net
gsll-devel	lhealy@common-lisp.net
gtk-cffi-devel	rklochkov@common-lisp.net
html-template-announce	edi@agharta.de
html-template-devel	edi@agharta.de
implementation-hackers	nikodemus@random-state.net
iolib-devel	sionescu@cddr.org
ip-interfaces-devel	elliottslaughter@gmail.com
iterate-devel	afuchs@common-lisp.net
langutils-devel	kraison@common-lisp.net
lift-devel	gwking@metabang.com
linedit-cvs	nikodemus@random-state.net
lispbox-cvs	aeriksen@common-lisp.net
lisp-game-dev	false
lisp-hh	edi@agharta.de
lisplab-cvs	jivestgarden@common-lisp.net
lisplab-devel	jivestgarden@common-lisp.net
lisppaste-devel	abridgewater@common-lisp.net
lispy-devel	mkennedy@common-lisp.net
l-math-announce	rneeser@common-lisp.net
lmud-devel	jcrippen@gmail.com
ltk-user	herth@peter-herth.de
mel-base-devel	js@codeartist.org
metacopy-devel	gking@common-lisp.net
metatilities-base-devel	gwking@metabang.com
mkcl-announce	jean.claude.beaudoin@gmail.com
mod-lisp-devel	mbattyani@common-lisp.net
movitz-devel	ffjeld@common-lisp.net
munich-lisp	jimka@rdrop.com
nixies-devel	fnadal@common-lisp.net
noctool-cvs	imattsson@common-lisp.net
oct-ticket	toy.raymond@gmail.com
pal-devel	tneste@common-lisp.net
parenscript-devel	vsedach@gmail.com
pg-devel	emarsden@common-lisp.net
phemlock-devel	gbaumann@common-lisp.net
postmodern-devel	marijnh@gmail.com
pro	hans@huebner.org
py-configparser-devel	ehuelsmann@common-lisp.net
qitab-devel	fahree@gmail.com
rdnzl-announce	edi@agharta.de
rdnzl-devel	edi@agharta.de
rfc2388-cvs	jdzerins@common-lisp.net
rucksack-devel	alemmens@xs4all.nl
seattle	danielp@sonic.net
slime-cvs	eller.helmut@gmail.com
snow-announce	astalla@common-lisp.net
snow-cvs	astalla@common-lisp.net
spray-devel	san@common-lisp.net
stefil-devel	alendvai@common-lisp.net
system-notifications	drewc@tech.coop
tbnl-announce	edi@agharta.de
teepeedee2-devel	jfremlin@common-lisp.net
tinaa-devel	gwking@metabang.com
toronto-lisp	omouse@gmail.com
trivial-garbage-devel	loliveira@common-lisp.net
trivial-gray-streams-devel	avodonosov@yandex.ru
trivial-utf-8-devel	mhaverbeke@common-lisp.net
uri-template-devel	vsedach@gmail.com
usocket-cvs	ehuelsmann@common-lisp.net
usocket-devel	ehuelsmann@common-lisp.net
vivace-graph-devel	kraison@common-lisp.net
web4r-devel-ja	tomoyuki28jp@gmail.com
xcvb-devel	fahree@gmail.com
zip-devel	dlichteblau@common-lisp.net
cl-twitter-devel	ieslick@common-lisp.net
cl-unification-devel	mantoniotti@common-lisp.net
cl-walker-devel	alendvai@common-lisp.net
cl-yacc-ebnf-devel	mnovikov@common-lisp.net
commonqt-devel	dlichteblau@common-lisp.net
definer-announce	mantoniotti@common-lisp.net
drakma-devel	edi@agharta.de
eclipse-devel	ihatchondo@common-lisp.net
editor-hints-devel	trittweiler@common-lisp.net
eurolisp	alemmens@xs4all.nl
fetter-devel	rhashem@common-lisp.net
flexi-streams-devel	edi@agharta.de
gecol-devel	ksprotte@common-lisp.net
gtk-cffi-cvs	rklochkov@common-lisp.net
heresy-devel	mlamari@common-lisp.net
hungarian-lispers	attila.lendvai@gmail.com
iolib-announce	sionescu@cddr.org
kpax-devel	scaekenberghe@common-lisp.net
lgtk-devel	mmommer@common-lisp.net
linedit-devel	nikodemus@random-state.net
lispbox-devel	aeriksen@common-lisp.net
lisp-interface-library-devel	fahree@gmail.com
lisp-machine	earl.kent@gmail.com
lisppaste-requests	bmastenbrook@common-lisp.net
l-math-devel	rneeser@common-lisp.net
local-time-devel	dlowe@dlowe.net
mcclim-devel	csr21@cantab.net
metabang-bind-devel	gking@common-lisp.net
mit-cadr-cvs	rjs@fdy2.co.uk
mkcl-devel	jean.claude.beaudoin@gmail.com
mop-standard-discuss	dan@telent.net
names-and-paths-devel	mantoniotti@common-lisp.net
oct-cvs	toy.raymond@gmail.com
osicat-devel	nikodemus@random-state.net
parenscript-announce	vsedach@common-lisp.net
plexippus-xpath-devel	ishvedunov@common-lisp.net
protobuf-devel	rbrown@common-lisp.net
python-on-lisp-devel	jsmith@common-lisp.net
regex-coach	edi@agharta.de
rucksack-cvs	alemmens@xs4all.nl
sicl-announce	mvilleneuve@common-lisp.net
sicl-devel	mvilleneuve@common-lisp.net
slime-devel	eller.helmut@gmail.com
snow-devel	astalla@common-lisp.net
s-xml-devel	bmastenbrook@common-lisp.net
tbnl-devel	edi@agharta.de
the-feebs-war-devel	gmilare@common-lisp.net
trivial-backtrace-devel	gwking@metabang.com
trivial-timeout-devel	gking@common-lisp.net
usocket-announce	ehuelsmann@common-lisp.net
usocket-ticket	ehuelsmann@common-lisp.net
web4r-devel	tomoyuki28jp@gmail.com
xuriella-devel	dlichteblau@common-lisp.net
zlib-devel	mvilleneuve@common-lisp.net
isidorus-devel	mkuster@common-lisp.net
isidorus-cvs	mkuster@common-lisp.net
isidorus-ticket	mkuster@common-lisp.net
cl-xmlspam-devel	rogpeppe@gmail.com
cmucl-ticket	toy.raymond@gmail.com
